32 10
RRRRRRRRRRRRRRRRRRRRRRRRRRRRRRRR
RRRRRRRRRRRRRRRRRRRRRRRRRRRRRRRR
RRRRRR...S....RRRRRR....S....RRR
................SS..............
................................
.P............................E.
RRRRRRRR.R.RRRRRRRRRRRR.R.RRRRRR
RRRRRRRRSRSRRRRRRRRRRRRSRSRRRRRR
RRRRRRRRRRRRRRRRRRRRRRRRRRRRRRRR
RRRRRRRRRRRRRRRRRRRRRRRRRRRRRRRR
