32 32
RRRRRRRRRRRRRRRRRRRRRRRRRRRRRRRR
RRRRRRRRRRRRRRRRRRRRRRRRRRRRRRRR
R..............................R
R..............................R
R..............................R
R..............................R
R..............................R
R..............................R
R..............................R
R..............................R
R..............................R
R..............................R
R..............................R
R..............................R
RG............................GR
RRRRRRRRRRRRRRRRRRRRRRRRRRRRRRRR
R..............................R
R..............................R
RKKKKKKKKKKKKKKKKKKKKKKKKKKKKKKR
RRRRRRRRRRRRRRRRRRRRRRRRRRRRRRRR
RRRRRRRRRRRRRRRRRRRRRRRRRRRRRRRR
R..............................R
R..............................R
RS...........S.................R
R.S.........S.S................R
R..S.......S...S.......S...S...R
R...S.....S.....S.....S.....S..R
R....S...S.RRRRR.S...S.......S.R
RRR...S.S.........S.S.........SR
RP.....S...........S..........ER
RRRRRRRRRRRRRRRRRRRRRRRRR.RRRRRR
RRRRRRRRRRRRRRRRRRRRRRRRRKKRRRRR
