32 32
RRRRRRRRRRRRRRRRRRRRRRRRRRRRRRRR
RRRRRRRRRRRRRRRRRRRRRRRRRRRRRRRR
RRRRRRRRRRRRRRRRRRRRRRRRRRRRRRRR
RRRRRRRRRSRRRRRRRRRRRRRRSRRRRRRR
RRRRRR...............S.......RRR
................................
.P..............................
RRRRRRRR....................S...
RRRRRRRR...KRRRRR...............
...........R.........R...S......
................................
..........R..............R......
..RRRR..........................
............RRR.............R...
...................RR...........
................................
..............RR......RRRR......
..........S.....................
...................RR...........
....S...........S..............R
................................
..........................S....R
.S.....S....S........S.....S....
..KKK....K....KKKKK...KK.....E..
RRRRRRRRRRRRRRRRRRRRRRRRRRRRRRRR
RRRRRRRRRRRRRRRRRRRRRRRRRRRRRRRR
RRRRRRRRRRRRRRRRRRRRRRRRRRRRRRRR
RRRRRRRRRRRRRRRRRRRRRRRRRRRRRRRR
RRRRRRRRRRRRRRRRRRRRRRRRRRRRRRRR
RRRRRRRRRRRRRRRRRRRRRRRRRRRRRRRR
RRRRRRRRRRRRRRRRRRRRRRRRRRRRRRRR
RRRRRRRRRRRRRRRRRRRRRRRRRRRRRRRR
