32 32
RRRRRRRRRRRRRRRRRRRRRRRRRRRRRRRR
RRRRRRRRRRRRRRRRRRRRRRRRRRRRRRRR
RRRRRRRRRRRRRRRRRRRRRRRRRRRRRRRR
RRRRRRRRRRRRRRRRRRRRRRRRRRRRRRRR
RRRRRRRRRRRRR..................R
RRRRRRRRR......................R
RRRRRR.........................R
RRRR.................RRR.......R
RR..............RRRR..S....E...R
R..........RRR.....S......RRR..R
R.....RRR....S.................R
R...R..........................R
R....R.........................R
R.....RRRRR..RRRR..R...........R
R......RRRRKKRRRRKKRRR.........R
RRRRRRRRRRRRRRRRRRRRRRR........R
R.....S.....S............R.....R
R...............S.......RRKKKKKR
R...................S..RRRRRRRRR
R.....R...RRRRRRRRRRRRRRRRRRRRRR
R......R.............RRRRRRRRRRR
R......RR............RRRRRRRRRRR
RKKKKKKRRRRRR........RRRRRRRRRRR
RRRRRRRRRR.....RRRR..RRRRRRRRRRR
R....................RRRRRRRRRRR
R...........R.G.....RRRRRRRRRRRR
R........RRRRRRRRRRRRRRRRRRRRRRR
R.P.RRR..RRRRRRRRRRRRRRRRRRRRRRR
RRRRRRRKKRRRRRRRRRRRRRRRRRRRRRRR
RRRRRRRRRRRRRRRRRRRRRRRRRRRRRRRR
RRRRRRRRRRRRRRRRRRRRRRRRRRRRRRRR
RRRRRRRRRRRRRRRRRRRRRRRRRRRRRRRR
