23 10
RRRRRRRRRRRRRRRRRRRRRRR
RRRR...RRRRRR...RRRRRRR
.......................
.......................
.......................
.....RRRR.......RRRR.E.
.P.RRRRRRRR...RRRRRRRRR
RRRRRRRRRRR...RRRRRRRRR
RRRRRRRRRRRSSSRRRRRRRRR
RRRRRRRRRRRRRRRRRRRRRRR
