32 32
RRRRRRRRRRRRRRRRRRRRRRRRRRRRRRRR
RRRRRRRRRRRRRRRRRRRRRRRRRRRRRRRR
RRRRRRRRRRRRRRRRRRRRRRRRRRRRRRRR
RRRRRRRRRRRRRRRRRRRRRRRRRRRRRRRR
R...............S.......S......R
R..............................R
R.P.................S..........R
RRRR.G.......G.RRRRRRRRRRR.....R
RRRRRRRRRRRRRRRRRRRRRRRRRR.....R
R...S.....S.....S.....S........R
R..............................R
R..RRRRRRRRRRRRRRRRRRRRRRRKKKKRR
R..RRRRRRRRRRRRRRRRRRRRRRRRRRRRR
R..RRRRRRRRRRRRRRRRRRRRRRRRRRRRR
R..RRRRRRRRRRRRRRRRRRRRRRRRRRRRR
R..RRRRRRRRRRRRRRRRRRRRRRRRRRRRR
R..............................R
R............................E.R
R..RR..RRR..RRR..RRR..RRR..RRRRR
R..RRKKRRRKKRRRKKRRRKKRRRKKRRRRR
R..RRRRRRRRRRRRRRRRRRRRRRRRRRRRR
R..RRRRRRRRRRRRRRRRRRRRRRRRRRRRR
R..RRRRRRRRRRRRRRRRRRRRRRRRRRRRR
R..RRRRRRRRRRRRRRRRRRRRRRRRRRRRR
R..RRRRRRRRRRRRRRRRRRRRRRRRRRRRR
R..RRRRRRRRRRRRRRRRRRRRRRRRRRRRR
R..RRRRRRRRRRRRRRRRRRRRRRRRRRRRR
R..RRRRRRRRRRRRRRRRRRRRRRRRRRRRR
RKKRRRRRRRRRRRRRRRRRRRRRRRRRRRRR
RRRRRRRRRRRRRRRRRRRRRRRRRRRRRRRR
RRRRRRRRRRRRRRRRRRRRRRRRRRRRRRRR
RRRRRRRRRRRRRRRRRRRRRRRRRRRRRRRR
